NO /Users/joel/42/4ring/Cube3d/textures/simonkraft/cobblestone_01.xpm
SO /Users/joel/42/4ring/Cube3d/textures/simonkraft/cobblestone_02.xpm
EA /Users/joel/42/4ring/Cube3d/textures/simonkraft/cobblestone.xpm
WE /Users/joel/42/4ring/Cube3d/textures/simonkraft/mossy_cobblestone1.xpm

F 0,2,2
C 78,252,3

1111111111111111111111111111111111111111111111111111111111111111111111
1S00000000000000000000000000000000000000000000000000000000000000000001
1000111111000000000000000000000000000000000000000000000000000000000001
1000100000000000000000000000000000000000000000000000000000000000000001            
1000100111000000000000000000000000000000000000000000000000000000000001
1000000000000000000000000000000000000000000000000000000000000000000001
1000000000000000000000000000000000000000000000000000000000000000000001
1000000000000000000000000000000000000000000000000000000000000000000001
1000000000000000000000000000000000000000000000000000000000000000000001
1000000000000000000000000000000000000000000000000000000000000000000001
1000000000000000000000000000000000000000000000000000000000000000000001
1000000000000000000000000000000000000000000000000000000000000000000001
1000000000000000000000000000000000000000000000000000000000000000000001
1000000000000000000000000000000000000000000000000000000000000000000001
1000000000000000000000000000000000000000000000000000000000000000000001
1000000000000000000000000000000000000000000000000000000000000000000001
1000000000000000000000000000000000000000000000000000000000000000000001
1000000000000000000000000000000000000000000000000000000000000000000001
1000000000000000000000000000000000000000000000000000000000000000000001
1000000000000000000000000000000000000000000000000000000000000000000001
1000000000000000000000000000000000000000000000000000000000000000000001
1000000000000000000000000000000000000000000000000000000000000000000001
1000000000000000000000000000000000000000000000000000000000000000000001
1000000000000000000000000000000000000000000000000000000000000000000001
1111111111111111111111111111111111111111111111111111111111111111111111