NO textures/simonkraft/bookshelf_01.xpm
EA textures/simonkraft/netherrack_02.xpm
SO textures/simonkraft/cobblestone.xpm
WE textures/simonkraft/soul_sand.xpm

F 0,0,0
C 78,252,3

1111111111111111111111111111111111111
1010101010101010101010101010101010101
1000000000000000000000000000000000001
100000000000000E000000000000000000001
1000000000000000000000000000000000001
1000000000000000000000000000000000001
1000000000000001000000000000000000001
1000000000000000000000000000000000001
1000000000000000000000000000000000001
1000000000000000000000000000000000001
1000000000000000000000000000000000001
1000000000000000000000000000000000001
1000000000000000000000000000000000001
1000000000000000000000000000000000001
1000000000000000000000000000000000001
1000000000000000000000000000000000001
1000000000000000000000000000000000001
1000000000000000000000000000000000001
1000000000000000000000000000000000001
1000000000000000000000000000000000001
1000000000000000000000000000000000001
1000000000000000000000000000000000001
1000000000000000000000000000000000001
1000000000000000000000000000000000001
1000000000000000000000000000000000001
1000000000000000000000000000000000001
1000000000000000000000000000000000001
1000000000000000000000000000000000001
1000000000000000000000000000000000001
1000000000000000000000000000000000001
1000000000000000000000000000000000001
1000000000000000000000000000000000001
1000000000000000000000000000000000001
1000000000000000000000000000000000001
1111111111111111111111111111111111111
