NO textures/simonkraft/bookshelf_01.xpm
EA textures/simonkraft/netherrack_02.xpm
SO textures/simonkraft/cobblestone.xpm
WE textures/simonkraft/soul_sand.xpm

F 255,255,255
C 0,0,50

1111111111
1E00000001
1111001111
1000000001
1111001111
1000000001
1111001111
1000000001
1111001111
1000000001
1111001111
1000000001
1111001111
1000000001
1111001111
1000000001
1111001111
1000000001
1111001111
1000000001
1111001111
1000000001
1111001111
1000000001
1111001111
1000000001
1111001111
1000000001
1111111111