NO textures/simonkraft/bookshelf_01.xpm
EA textures/simonkraft/netherrack_02.xpm
SO textures/simonkraft/cobblestone.xpm
WE textures/simonkraft/soul_sand.xpm

F 255,255,255
C 0,0,50

11111111
10000001
10001001
1000N001
11111111