NO textures/simonkraft/bookshelf_01.xpm
SO textures/simonkraft/cobblestone.xpm
EA textures/simonkraft/soul_sand.xpm
WE textures/simonkraft/netherrack_02.xpm

F 0,0,0
C 78,252,3

11111
10001
10W01
10001
11111